1111111111111
1C01000000001
11000000011E1
1P00110000001
1111111111111