1111111111111
1C00001000C01
11000C00100E1
1P0010000C001
1111111111111